11111111111111111111111111111111111
1000000000000C00000000000000000C001
10100000010101V010100101000100001E1
101V00111010100C00000C00000000C0111
101000001010100C00001000000V0010001
1010101CC0101001V100101000010100001
10100101011010110101010000101100101
1000000P0V000C0C0101010100C00C00001
11111111111111111111111111111111111