11111111111111111111111111
1CCCCCCCCCCC11CCCCCCCCCCC1
1C1111C1111C11C1111C1111C1
1C1111C1111C11C1111C1111C1
1C1111C1111C11C1111C1111C1
1CCCCCVCCCCCCCCCCCCVCCCCC1
1C111CC1C11111111C1CC111C1
1CCCCCC1CCCC11CCCC1CCCCCC1
111111C111101101111C111111
111111C1V000P0000V1C111111
111111C101CCCCCC101C111111
1ECCCCC0VVCVVVVCVV0CCCCC01
111111C101111111101C111111
111111C100000000001C111111
111111C101111111101C111111
1CCCCCCCCCCC11CCCCCCCCCCC1
11111111111111111111111111